




                                                ######

                                                                        
                                                       #####                  
                                                ####                          
                                                                           
                                        #####                                    
         ########                                                                                   
                    #              #                                          
#########        ##########      ####### #  ###### ###########################