






                                                                                                                                                              #####################################   
                                                                                                                                                      #######
                                                                                                                                        #########
                                                                                                                              #######
                                                                                                                 ##########
         ########                                                                                   
                    #                                                                       ###############################################################################################################################################     
#########        ##########      ####### #  ###### ########################################################################################################################################################################################